HMX1	probable,biallelic
CEP290	confirmed,biallelic
FLNA	confirmed,hemizygous
SLX4	confirmed,biallelic
ARG1	confirmed,biallelic
POLR3A	confirmed,biallelic
ATR	probable,biallelic
FANCB	confirmed,hemizygous
ALG9	probable,biallelic
NTRK1	confirmed,biallelic
MYH9	confirmed,monoallelic
YAP1	probable,monoallelic
BBS9	confirmed,biallelic
TRIM32	confirmed,biallelic
PAX2	confirmed,monoallelic
FGFR3	confirmed,monoallelic
NSD1	confirmed,monoallelic
ADAR	confirmed,monoallelic
MTOR	possible,monoallelic
MFRP	confirmed,biallelic
FEZF1	probable,biallelic
FLNB	confirmed,biallelic
NAA10	confirmed,x-linked dominant
MOGS	probable,biallelic
AGPS	confirmed,biallelic
OFD1	confirmed,x-linked dominant
PAFAH1B1	confirmed,monoallelic
COL1A1	confirmed,monoallelic
COL1A1	confirmed,monoallelic
CAMTA1	probable,monoallelic
CHST3	confirmed,biallelic
HRAS	confirmed,monoallelic
RPGRIP1	confirmed,biallelic
RIPK4	confirmed,biallelic
BRIP1	confirmed,biallelic
OFD1	confirmed,hemizygous
TBX3	confirmed,monoallelic
LAMA1	confirmed,biallelic
ERLIN2	possible,biallelic
PCCA	confirmed,biallelic
FKRP	confirmed,biallelic
COX15	confirmed,biallelic
COG7	confirmed,biallelic
SCN2A	confirmed,monoallelic
MECP2	confirmed,x-linked dominant
BRAF	confirmed,monoallelic
FTL	confirmed,monoallelic
CBL	confirmed,monoallelic
POMGNT1	confirmed,biallelic
COL2A1	confirmed,monoallelic
TGFB3	confirmed,monoallelic
PIGO	confirmed,biallelic
GJA1	confirmed,biallelic
PLK4	confirmed,biallelic
ARSA	confirmed,biallelic
CLN3	confirmed,biallelic
LRP5	confirmed,monoallelic
FOXP2	probable,monoallelic
DOCK6	probable,biallelic
SLC6A3	confirmed,biallelic
PITX3	confirmed,monoallelic
CHAMP1	confirmed,monoallelic
XPC	confirmed,biallelic
FOXE3	confirmed,biallelic
SUMO1	possible,monoallelic
STAT1	confirmed,biallelic
CLN8	confirmed,biallelic
RTEL1	confirmed,biallelic
GDF3	possible,monoallelic
MKKS	confirmed,biallelic
NBAS	confirmed,biallelic
NPHS1	confirmed,biallelic
ACAN	confirmed,monoallelic
GJA8	confirmed,monoallelic
LRPAP1	possible,biallelic
FLNA	confirmed,x-linked dominant
NAGA	confirmed,biallelic
PLCB1	probable,biallelic
NT5C3A	confirmed,biallelic
SLC4A11	both DD and IF,biallelic
ARX	confirmed,hemizygous
SMARCA2	confirmed,monoallelic
IQSEC2	confirmed,hemizygous
VSX2	confirmed,biallelic
CEP290	confirmed,biallelic
NSDHL	confirmed,hemizygous
DPAGT1	confirmed,biallelic
KBTBD13	confirmed,monoallelic
SOX9	confirmed,monoallelic
AMER1	both DD and IF,monoallelic
PLCB4	probable,monoallelic
LGI1	possible,monoallelic
NEK8	probable,biallelic
LDB3	both DD and IF,monoallelic
TRAPPC2	confirmed,hemizygous
HOXC13	confirmed,biallelic
CDC6	confirmed,biallelic
IFT140	confirmed,biallelic
PIGV	confirmed,biallelic
MSX1	confirmed,monoallelic
MAGEL2	confirmed,imprinted
STIM1	possible,monoallelic
SLC2A1	confirmed,monoallelic
TWIST2	confirmed,monoallelic
GRHL2	probable,biallelic
HADH	confirmed,biallelic
PRRT2	confirmed,biallelic
GDF5	confirmed,biallelic
PAFAH1B1	confirmed,monoallelic
OTC	confirmed,hemizygous
EXPH5	probable,biallelic
ZEB1	possible,monoallelic
CRYBB2	confirmed,monoallelic
STAT5B	probable,biallelic
SALL1	confirmed,monoallelic
PDE6G	confirmed,biallelic
NEK8	probable,biallelic
JAM3	probable,biallelic
NALCN	confirmed,monoallelic
FOXN1	confirmed,biallelic
ATP7A	confirmed,hemizygous
BBS10	confirmed,biallelic
MTO1	confirmed,biallelic
FTO	possible,biallelic
GBA	both DD and IF,biallelic
XYLT1	confirmed,biallelic
CHRNG	confirmed,biallelic
CHSY1	confirmed,biallelic
POMT2	confirmed,biallelic
NOG	confirmed,monoallelic
KIF1BP	confirmed,biallelic
IFT172	confirmed,biallelic
CC2D2A	confirmed,biallelic
INPP5E	confirmed,biallelic
CACNA1D	probable,biallelic
SATB2	confirmed,monoallelic
GATA6	confirmed,monoallelic
DOCK8	confirmed,biallelic
SLC46A1	confirmed,biallelic
DMPK	confirmed,monoallelic
AGA	confirmed,biallelic
CSTA	probable,biallelic
SLC25A38	confirmed,biallelic
COL11A2	confirmed,biallelic
DLX5	possible,biallelic
BRCA1	both DD and IF,biallelic
ABCC6	confirmed,biallelic
AFF2	confirmed,hemizygous
FLNB	confirmed,monoallelic
MRPS22	probable,biallelic
HOXA1	confirmed,biallelic
KCNE1	both DD and IF,biallelic
GPSM2	confirmed,biallelic
ACTB	confirmed,monoallelic
PXDN	probable,biallelic
AFG3L2	child IF,monoallelic
EBP	confirmed,x-linked dominant
CACNA1D	probable,monoallelic
PSMB8	confirmed,biallelic
NALCN	confirmed,biallelic
ASCC3	possible,biallelic
LAMC3	confirmed,biallelic
PITX2	confirmed,monoallelic
XRCC4	confirmed,biallelic
PEX13	confirmed,biallelic
MAT1A	probable,biallelic
SCN11A	confirmed,monoallelic
COL9A1	confirmed,biallelic
NKX2-5	confirmed,monoallelic
CRB1	confirmed,biallelic
TCF4	confirmed,monoallelic
GFM1	confirmed,biallelic
TUBA8	confirmed,biallelic
IGF2	confirmed,imprinted
COL1A1	confirmed,monoallelic
FGFR2	confirmed,monoallelic
BBS4	confirmed,biallelic
SLC24A4	probable,biallelic
PCNT	confirmed,biallelic
BUB1B	confirmed,biallelic
EYA1	confirmed,monoallelic
NAGS	confirmed,biallelic
SNAP29	probable,biallelic
TBX1	confirmed,monoallelic
RPS6KA3	confirmed,hemizygous
SLC25A15	confirmed,biallelic
PYGL	confirmed,biallelic
BRAT1	probable,biallelic
ATP7A	confirmed,hemizygous
RFT1	probable,biallelic
ALDH18A1	confirmed,monoallelic
PYCR1	confirmed,biallelic
GDI1	confirmed,hemizygous
COQ2	confirmed,biallelic
GLDC	confirmed,biallelic
TBL1XR1	probable,monoallelic
L1CAM	confirmed,hemizygous
NOP10	possible,biallelic
MPDU1	confirmed,biallelic
TCTN2	probable,biallelic
COL2A1	confirmed,monoallelic
PLEC	possible,biallelic
TCTN1	probable,biallelic
SLC4A1	both DD and IF,monoallelic
FANCC	confirmed,biallelic
CNTNAP2	confirmed,biallelic
SMARCE1	probable,monoallelic
MRE11	confirmed,biallelic
RABL6	possible,biallelic
DDB2	confirmed,biallelic
FAT4	confirmed,biallelic
MYH9	confirmed,monoallelic
FGFR3	confirmed,monoallelic
PIK3R1	confirmed,monoallelic
VSX2	confirmed,biallelic
VPS13B	confirmed,biallelic
ERCC3	confirmed,biallelic
SMPD1	confirmed,biallelic
WNT4	probable,biallelic
GLUD1	confirmed,monoallelic
SLC4A1	both DD and IF,biallelic
B3GALT6	confirmed,biallelic
HADHA	confirmed,biallelic
FLNA	confirmed,hemizygous
DDHD1	confirmed,biallelic
SLC52A3	confirmed,biallelic
FRY	possible,biallelic
HUWE1	confirmed,hemizygous
DYNC1H1	confirmed,monoallelic
MEGF10	confirmed,biallelic
ARL14EP	possible,biallelic
ADGRG1	confirmed,biallelic
MPLKIP	confirmed,biallelic
L1CAM	confirmed,hemizygous
WT1	confirmed,monoallelic
RECQL4	confirmed,biallelic
LDB3	both DD and IF,monoallelic
B3GALT6	confirmed,biallelic
CHRDL1	confirmed,hemizygous
DVL1	confirmed,monoallelic
CNKSR1	possible,biallelic
DSTYK	confirmed,monoallelic
TMEM114	possible,monoallelic
ALG8	confirmed,biallelic
MASP1	confirmed,biallelic
ROR2	confirmed,biallelic
KCNC3	both DD and IF,monoallelic
NDP	confirmed,hemizygous
KAT6A	confirmed,monoallelic
BCOR	confirmed,x-linked dominant
ADAMTS18	possible,biallelic
HDAC8	confirmed,hemizygous
HDAC8	confirmed,x-linked dominant
PDSS1	probable,biallelic
FREM2	confirmed,biallelic
HSPG2	confirmed,biallelic
ALG1	confirmed,biallelic
AUTS2	confirmed,monoallelic
MYH9	confirmed,monoallelic
RARS2	confirmed,biallelic
POLD1	both DD and IF,monoallelic
LRAT	probable,biallelic
KARS	both DD and IF,biallelic
GNPTAB	confirmed,biallelic
SLC35C1	confirmed,biallelic
SATB2	confirmed,monoallelic
SNX3	possible,monoallelic
NDUFS8	confirmed,biallelic
PHC1	possible,biallelic
SCN4A	confirmed,monoallelic
KRIT1	both DD and IF,monoallelic
ALG11	probable,biallelic
PEX5	confirmed,biallelic
GDF1	possible,monoallelic
HESX1	probable,biallelic
TRMT1	possible,biallelic
WDR60	confirmed,biallelic
IKBKG	confirmed,hemizygous
DLL3	confirmed,biallelic
RASA1	confirmed,monoallelic
FANCF	confirmed,biallelic
FH	confirmed,biallelic
POMGNT1	confirmed,biallelic
MYO7A	both DD and IF,biallelic
RUNX2	confirmed,monoallelic
CRYGC	confirmed,monoallelic
OCRL	confirmed,hemizygous
RFX6	confirmed,biallelic
LRPPRC	confirmed,biallelic
NUP62	probable,biallelic
NPR2	confirmed,biallelic
PET100	probable,biallelic
SRCAP	confirmed,monoallelic
COASY	confirmed,biallelic
NPHP4	confirmed,biallelic
PRRX1	possible,monoallelic
PRRX1	possible,biallelic
EVC	confirmed,biallelic
SCN1A	confirmed,monoallelic
COL9A1	confirmed,monoallelic
ZFYVE26	confirmed,biallelic
PARP1	possible,biallelic
DEAF1	confirmed,monoallelic
PLEC	possible,biallelic
WDR35	confirmed,biallelic
SCAPER	possible,biallelic
ELN	confirmed,monoallelic
RNASEH2A	confirmed,biallelic
GJB3	both DD and IF,monoallelic
AP4M1	probable,biallelic
NR2F2	confirmed,monoallelic
C12orf57	probable,biallelic
SMARCB1	confirmed,monoallelic
MOCS1	confirmed,biallelic
PAX6	confirmed,monoallelic
DLAT	confirmed,biallelic
SH3PXD2B	confirmed,biallelic
FLNA	confirmed,x-linked dominant
NR2F1	confirmed,monoallelic
SRPX2	probable,hemizygous
KAT6B	confirmed,monoallelic
GLI3	confirmed,monoallelic
FAM134B	confirmed,biallelic
PIP5K1C	possible,biallelic
PAH	confirmed,biallelic
TGFBR1	confirmed,monoallelic
FKTN	confirmed,biallelic
LMNA	both DD and IF,monoallelic
GHR	confirmed,biallelic
COQ4	probable,biallelic
PAX9	confirmed,monoallelic
FHL1	confirmed,hemizygous
CDH23	confirmed,biallelic
TRPM1	confirmed,biallelic
PEX13	confirmed,biallelic
AP1S2	confirmed,hemizygous
STS	confirmed,hemizygous
ALPL	confirmed,biallelic
GLI2	confirmed,monoallelic
ASAH1	confirmed,biallelic
MMAA	confirmed,biallelic
PEX14	confirmed,biallelic
FLNB	confirmed,monoallelic
PGAP2	confirmed,biallelic
STRA6	confirmed,biallelic
ZNF711	confirmed,hemizygous
PRSS12	confirmed,biallelic
MYH3	confirmed,monoallelic
FKRP	confirmed,biallelic
HCCS	confirmed,x-linked dominant
STAMBP	confirmed,biallelic
NKX3-2	confirmed,biallelic
NSUN2	probable,biallelic
TGFBR2	confirmed,monoallelic
PEX16	confirmed,biallelic
ITCH	probable,biallelic
DPM3	probable,biallelic
DDC	confirmed,biallelic
NFU1	confirmed,biallelic
DEPDC5	confirmed,monoallelic
SYT1	possible,monoallelic
PIK3CA	confirmed,mosaic
INPP5E	confirmed,biallelic
DHODH	confirmed,biallelic
PRPS1	confirmed,hemizygous
GDF5	confirmed,monoallelic
GLB1	confirmed,biallelic
DMP1	confirmed,biallelic
RAX	confirmed,biallelic
SLC25A19	probable,biallelic
B3GALNT2	probable,biallelic
ARHGAP31	probable,monoallelic
BBS5	confirmed,biallelic
PECR	possible,biallelic
MPDZ	possible,biallelic
DHTKD1	probable,biallelic
ABCB6	possible,monoallelic
SLC6A1	confirmed,monoallelic
HSPD1	both DD and IF,biallelic
ANO5	both DD and IF,biallelic
GAMT	confirmed,biallelic
SLC2A10	confirmed,biallelic
FLNA	confirmed,hemizygous
CFC1	probable,monoallelic
PLOD3	possible,biallelic
ARID1B	confirmed,monoallelic
PLXND1	possible,monoallelic
PLCG2	possible,monoallelic
SHROOM3	probable,monoallelic
VRK1	probable,biallelic
FGFR2	confirmed,monoallelic
WWOX	probable,biallelic
BRAF	confirmed,monoallelic
AGL	confirmed,biallelic
TRPS1	confirmed,monoallelic
BMP4	confirmed,monoallelic
KLHL40	confirmed,biallelic
LRP2	possible,monoallelic
MGAT2	confirmed,biallelic
SOX11	probable,monoallelic
ATP13A2	both DD and IF,biallelic
RELN	confirmed,biallelic
GALT	confirmed,biallelic
UGT1A1	confirmed,biallelic
LYST	confirmed,biallelic
ZEB2	confirmed,monoallelic
TTC8	confirmed,biallelic
PRKAR1A	confirmed,monoallelic
IFT43	confirmed,biallelic
FLVCR2	confirmed,biallelic
CYP2U1	confirmed,biallelic
ANTXR1	confirmed,biallelic
OCRL	confirmed,hemizygous
NPHS2	confirmed,biallelic
HOXD13	confirmed,monoallelic
EHMT1	confirmed,monoallelic
CDT1	confirmed,biallelic
TTN	possible,biallelic
FBLN1	possible,biallelic
PTPRF	possible,biallelic
SLC13A5	confirmed,biallelic
ERCC6	confirmed,biallelic
MANBA	confirmed,biallelic
PTDSS1	confirmed,monoallelic
ARHGEF9	possible,hemizygous
RSPO4	confirmed,biallelic
SLC25A20	confirmed,biallelic
WNT10B	confirmed,biallelic
GBA	both DD and IF,biallelic
PEX1	confirmed,biallelic
TREX1	confirmed,biallelic
KCNA2	confirmed,monoallelic
KCNA2	confirmed,monoallelic
RAD21	confirmed,monoallelic
SZT2	probable,biallelic
HPD	probable,monoallelic
GNPAT	confirmed,biallelic
DNM1	probable,monoallelic
COG5	probable,biallelic
HEXB	confirmed,biallelic
EYA1	possible,monoallelic
MED13L	probable,monoallelic
MESP2	confirmed,biallelic
CDK5RAP2	probable,biallelic
CTNS	confirmed,biallelic
PCBD1	confirmed,biallelic
TEK	confirmed,monoallelic
BCAP31	confirmed,hemizygous
MYH6	both DD and IF,monoallelic
HSD17B4	confirmed,biallelic
KANK1	possible,imprinted
ANKRD11	confirmed,monoallelic
HOXD13	confirmed,monoallelic
PHF21A	probable,monoallelic
ZEB1	possible,monoallelic
VANGL1	possible,monoallelic
NF1	confirmed,monoallelic
OFD1	confirmed,hemizygous
BPIFB6	possible,monoallelic
IKBKG	confirmed,monoallelic
PTF1A	confirmed,biallelic
ASCL1	possible,biallelic
FLG	possible,biallelic
PIGQ	possible,biallelic
ALDH18A1	confirmed,biallelic
WNT7A	confirmed,biallelic
SCN4A	confirmed,monoallelic
FOXL2	probable,monoallelic
CFL2	probable,biallelic
MED17	probable,biallelic
SMARCA4	confirmed,monoallelic
SLC5A5	confirmed,biallelic
ACTA2	both DD and IF,monoallelic
FANCG	confirmed,biallelic
FBXW4	possible,monoallelic
ASPH	probable,biallelic
TUBB2A	confirmed,monoallelic
SUMF1	confirmed,biallelic
PEX6	confirmed,biallelic
CIB2	confirmed,biallelic
RNF135	confirmed,monoallelic
PDCD10	both DD and IF,monoallelic
C2CD3	probable,biallelic
CEP41	confirmed,biallelic
GJB3	both DD and IF,monoallelic
NF1	confirmed,monoallelic
HCN1	confirmed,monoallelic
TGFB1	confirmed,monoallelic
PTEN	confirmed,monoallelic
FGFR1	confirmed,monoallelic
SGSH	confirmed,biallelic
TLL1	possible,monoallelic
SATB2	confirmed,monoallelic
GRIK2	confirmed,biallelic
ORC1	confirmed,biallelic
FANCE	confirmed,biallelic
SYNE1	both DD and IF,biallelic
ARL6	confirmed,biallelic
PTEN	confirmed,monoallelic
QKI	possible,monoallelic
IDUA	confirmed,biallelic
STXBP1	confirmed,monoallelic
DNMT3A	confirmed,monoallelic
UVSSA	confirmed,biallelic
PTPN14	probable,biallelic
ROBO3	confirmed,biallelic
BBS1	confirmed,biallelic
IDUA	confirmed,biallelic
ALX1	confirmed,biallelic
NSD1	confirmed,monoallelic
BMP4	confirmed,monoallelic
WNT3	confirmed,biallelic
MT-TP	confirmed,mitochondrial
ALG12	confirmed,biallelic
OXCT1	confirmed,biallelic
LRP5	confirmed,monoallelic
NFIX	confirmed,monoallelic
MFSD8	confirmed,biallelic
ERCC2	confirmed,biallelic
PDSS2	confirmed,biallelic
GUSB	confirmed,biallelic
HSD17B10	confirmed,hemizygous
RET	both DD and IF,biallelic
RIT1	confirmed,monoallelic
ZFP57	confirmed,biallelic
ZMPSTE24	confirmed,biallelic
ERCC4	probable,biallelic
TAC3	probable,biallelic
RTEL1	confirmed,biallelic
GDF5	confirmed,biallelic
PEX26	confirmed,biallelic
DARS2	both DD and IF,biallelic
MLYCD	confirmed,biallelic
KIT	both DD and IF,monoallelic
IGF2	confirmed,imprinted
RBM28	possible,biallelic
HGSNAT	confirmed,biallelic
GCDH	confirmed,biallelic
PIGL	confirmed,biallelic
ZFPM2	possible,monoallelic
DYX1C1	confirmed,biallelic
AMPD2	confirmed,biallelic
ABCC9	confirmed,monoallelic
CLPP	probable,biallelic
KDM6A	confirmed,x-linked dominant
ASPM	confirmed,biallelic
SHOX	confirmed,biallelic
PRRT2	confirmed,monoallelic
GDF6	confirmed,monoallelic
TMEM67	confirmed,biallelic
ZIC3	confirmed,hemizygous
ACVR2B	possible,monoallelic
HRAS	confirmed,monoallelic
KCNC1	confirmed,monoallelic
CHRNB2	probable,monoallelic
MITF	confirmed,monoallelic
MMADHC	confirmed,biallelic
GALK1	confirmed,biallelic
NYX	confirmed,hemizygous
CRB2	confirmed,biallelic
PC	confirmed,biallelic
TMEM237	confirmed,biallelic
PEX12	confirmed,biallelic
CCDC78	probable,monoallelic
GATA4	confirmed,monoallelic
SCN8A	confirmed,monoallelic
TMEM5	confirmed,biallelic
PITX2	confirmed,monoallelic
GABRB3	confirmed,monoallelic
SCN2A	confirmed,monoallelic
CRYAB	possible,monoallelic
FOXF1	confirmed,monoallelic
SOX2	confirmed,monoallelic
ARX	confirmed,hemizygous
PEX26	confirmed,biallelic
SURF1	confirmed,biallelic
GRIN2B	confirmed,monoallelic
KIF11	confirmed,monoallelic
CTCF	confirmed,monoallelic
EXT2	confirmed,monoallelic
TSEN34	probable,biallelic
RPGRIP1L	confirmed,biallelic
COL1A1	confirmed,monoallelic
ABCD4	probable,biallelic
OPHN1	confirmed,hemizygous
GJB2	confirmed,biallelic
ZDHHC15	possible,x-linked dominant
ACADM	confirmed,biallelic
MYO5A	confirmed,biallelic
SMAD3	confirmed,monoallelic
TACR3	probable,biallelic
LRRC6	confirmed,biallelic
CASK	confirmed,x-linked dominant
ETFDH	confirmed,biallelic
TFAP2B	confirmed,monoallelic
DDX3X	confirmed,x-linked dominant
DDX3X	confirmed,hemizygous
AR	both DD and IF,hemizygous
TRPV3	probable,monoallelic
SALL4	confirmed,monoallelic
GRHL3	confirmed,monoallelic
IRF6	confirmed,monoallelic
ARFGEF2	probable,biallelic
HYLS1	confirmed,biallelic
SACS	probable,biallelic
BANF1	probable,biallelic
AR	both DD and IF,hemizygous
NR1I3	possible,monoallelic
ZDHHC9	confirmed,hemizygous
DYM	confirmed,biallelic
FOXC1	confirmed,monoallelic
KCNMA1	possible,monoallelic
NDUFV1	confirmed,biallelic
DOLK	confirmed,biallelic
ATRX	confirmed,hemizygous
IFT122	confirmed,biallelic
NKX2-5	confirmed,monoallelic
SLC6A5	confirmed,biallelic
WDR19	confirmed,biallelic
ACTA2	both DD and IF,monoallelic
CEP152	confirmed,biallelic
DSPP	confirmed,monoallelic
DSPP	confirmed,monoallelic
CLCN7	confirmed,biallelic
OTOGL	confirmed,biallelic
PTHLH	confirmed,monoallelic
GJB2	confirmed,monoallelic
TBC1D24	confirmed,biallelic
MYH6	both DD and IF,monoallelic
MAFB	confirmed,monoallelic
C12orf65	confirmed,biallelic
PKHD1	confirmed,biallelic
DCX	confirmed,x-linked dominant
FAM111A	confirmed,monoallelic
MPI	confirmed,biallelic
POC1B	confirmed,biallelic
MCCC2	confirmed,biallelic
PDHA1	confirmed,hemizygous
FGFR1	confirmed,monoallelic
CRX	confirmed,monoallelic
CRYAA	confirmed,biallelic
GJC2	confirmed,monoallelic
NRXN2	probable,monoallelic
JAGN1	confirmed,biallelic
PMM2	confirmed,biallelic
SOX10	confirmed,monoallelic
UMPS	confirmed,biallelic
VSX2	confirmed,biallelic
PEX19	confirmed,biallelic
SLC4A4	confirmed,biallelic
FOXE1	confirmed,biallelic
BLOC1S6	probable,biallelic
LDB3	both DD and IF,monoallelic
DSG1	probable,biallelic
ARL6	confirmed,biallelic
SPTAN1	probable,monoallelic
ABCB11	confirmed,biallelic
GNAO1	confirmed,monoallelic
ALAD	both DD and IF,biallelic
LEMD3	confirmed,monoallelic
TMEM67	confirmed,biallelic
FLVCR1	confirmed,biallelic
COL2A1	confirmed,monoallelic
TMEM216	probable,biallelic
THRA	confirmed,monoallelic
CLCNKB	probable,biallelic
BFSP2	confirmed,monoallelic
TUBGCP6	confirmed,biallelic
RRAS	probable,monoallelic
FLNA	confirmed,hemizygous
NECTIN4	confirmed,biallelic
FRMD7	confirmed,hemizygous
COL1A1	confirmed,monoallelic
GLUL	confirmed,biallelic
ORC4	confirmed,biallelic
COLEC11	confirmed,biallelic
CRYGD	possible,monoallelic
CHD7	confirmed,monoallelic
NEDD4L	possible,monoallelic
CEP290	confirmed,biallelic
ZIC2	confirmed,monoallelic
GRIN2A	confirmed,monoallelic
FMR1	both DD and IF,hemizygous
TBC1D24	confirmed,biallelic
NFIA	possible,monoallelic
WDR45	confirmed,x-linked dominant
TECPR2	probable,biallelic
ROR2	confirmed,monoallelic
NEU1	confirmed,biallelic
LMNA	both DD and IF,monoallelic
QARS	probable,biallelic
COL1A1	confirmed,monoallelic
CDH3	confirmed,biallelic
COL1A1	confirmed,monoallelic
PAX3	confirmed,monoallelic
NKX2-1	confirmed,monoallelic
SNRPB	confirmed,monoallelic
CTSA	confirmed,biallelic
HOXA1	confirmed,biallelic
GON4L	possible,biallelic
BMPER	confirmed,biallelic
GJA1	confirmed,monoallelic
SLC19A3	confirmed,biallelic
ZFPM2	possible,monoallelic
SOX17	confirmed,monoallelic
GRIN2B	confirmed,monoallelic
AGK	confirmed,biallelic
CRYAB	possible,biallelic
ARHGEF6	possible,hemizygous
BCL11A	confirmed,monoallelic
GNAS	confirmed,imprinted
GNS	confirmed,biallelic
WDR60	confirmed,biallelic
FOXC1	confirmed,monoallelic
WWOX	probable,biallelic
ARX	confirmed,hemizygous
CRYBB1	confirmed,biallelic
CRYBB1	confirmed,monoallelic
SLC6A8	confirmed,hemizygous
PHGDH	confirmed,biallelic
PEX26	confirmed,biallelic
MTF1	possible,monoallelic
LMNA	both DD and IF,monoallelic
ALDH5A1	confirmed,biallelic
PEX7	confirmed,biallelic
NDUFS4	confirmed,biallelic
COL4A1	both DD and IF,monoallelic
POMT1	confirmed,biallelic
NRXN3	possible,monoallelic
PTHLH	confirmed,monoallelic
C8orf37	confirmed,biallelic
GLB1	confirmed,biallelic
ARX	confirmed,hemizygous
CAV1	possible,biallelic
SLC39A13	confirmed,biallelic
CEP63	probable,biallelic
BICD2	confirmed,monoallelic
KRT74	probable,monoallelic
B4GALT7	confirmed,biallelic
EEF1B2	possible,biallelic
RUBCN	possible,biallelic
DHFR	confirmed,biallelic
HARS	possible,biallelic
CA2	confirmed,biallelic
GCSH	possible,biallelic
CHUK	confirmed,biallelic
HSF4	confirmed,monoallelic
RAD51	probable,monoallelic
ZMPSTE24	confirmed,biallelic
FGFR2	confirmed,monoallelic
FGFR1	confirmed,monoallelic
GALC	confirmed,biallelic
RNASEH2B	confirmed,biallelic
ACOX1	confirmed,biallelic
CACNA1A	possible,monoallelic
CDH15	possible,monoallelic
MIR17HG	probable,monoallelic
DHCR24	confirmed,biallelic
ZBTB16	possible,biallelic
GFAP	confirmed,monoallelic
HESX1	probable,monoallelic
MAP2K1	confirmed,monoallelic
L1CAM	confirmed,hemizygous
TBCE	confirmed,biallelic
SLC25A22	probable,biallelic
NRXN1	probable,monoallelic
JAG1	confirmed,monoallelic
SOX3	confirmed,x-linked dominant
TIMM8A	both DD and IF,hemizygous
SCARF2	confirmed,biallelic
DCAF17	possible,biallelic
MTRR	confirmed,biallelic
TP63	confirmed,monoallelic
RALGDS	possible,biallelic
ALG13	probable,hemizygous
ALG13	probable,x-linked dominant
TTC8	confirmed,biallelic
LAMA2	confirmed,biallelic
PLP1	confirmed,hemizygous
PTS	confirmed,biallelic
COL10A1	confirmed,monoallelic
FBN2	confirmed,monoallelic
AAAS	confirmed,biallelic
KLF8	possible,monoallelic
IMPAD1	confirmed,biallelic
USP9X	probable,hemizygous
USP9X	probable,x-linked dominant
HPD	probable,biallelic
DNAAF3	confirmed,biallelic
SLC6A17	probable,biallelic
DNMT3B	confirmed,biallelic
FMR1	confirmed,hemizygous
SMC3	confirmed,monoallelic
GJC2	confirmed,monoallelic
SMOC1	confirmed,biallelic
GDI1	confirmed,hemizygous
SLC2A2	confirmed,biallelic
DNA2	possible,biallelic
CTNS	confirmed,biallelic
LRP2	confirmed,biallelic
ZNF526	possible,biallelic
ESCO2	confirmed,biallelic
CCBE1	confirmed,biallelic
DYNC2H1	confirmed,biallelic
RNU4ATAC	confirmed,biallelic
RAPSN	confirmed,biallelic
POGZ	confirmed,monoallelic
WNT7A	confirmed,biallelic
CD151	probable,biallelic
TUBA1A	confirmed,monoallelic
ACADS	both DD and IF,biallelic
ADSL	confirmed,biallelic
NR5A1	both DD and IF,monoallelic
LMNA	both DD and IF,biallelic
COG1	confirmed,biallelic
GNAS	confirmed,mosaic
ELOVL4	confirmed,biallelic
NDST1	possible,biallelic
FMN2	probable,biallelic
TUBB	confirmed,monoallelic
HOXD13	confirmed,monoallelic
RET	both DD and IF,monoallelic
ZC4H2	confirmed,hemizygous
ZC4H2	confirmed,x-linked dominant
CLN6	both DD and IF,biallelic
SHANK3	probable,monoallelic
PDHA1	confirmed,monoallelic
CLDN19	confirmed,biallelic
MYO7A	both DD and IF,biallelic
ALS2	confirmed,biallelic
ERCC6	confirmed,biallelic
SHH	confirmed,monoallelic
ARX	confirmed,hemizygous
TMEM67	confirmed,biallelic
ADRA2B	possible,biallelic
BOLA3	probable,biallelic
TCF12	confirmed,monoallelic
TAT	confirmed,biallelic
TTC19	confirmed,biallelic
SOX10	confirmed,monoallelic
PURA	confirmed,monoallelic
GJC2	confirmed,biallelic
SLC12A5	possible,monoallelic
MNX1	confirmed,monoallelic
ADA	confirmed,biallelic
GRIN2B	confirmed,monoallelic
ATP7A	confirmed,hemizygous
AASS	probable,biallelic
GATA6	confirmed,monoallelic
TFAP2A	confirmed,monoallelic
TBXAS1	confirmed,biallelic
LHX4	confirmed,monoallelic
FANCL	probable,biallelic
EDA	confirmed,hemizygous
MED23	possible,biallelic
GBA	both DD and IF,biallelic
COL11A1	confirmed,biallelic
ATP1A3	both DD and IF,monoallelic
SLC22A5	confirmed,biallelic
AIFM1	probable,hemizygous
SCN4A	confirmed,monoallelic
KCNJ11	confirmed,biallelic
PSPH	confirmed,biallelic
GLB1	confirmed,biallelic
UBE2A	confirmed,hemizygous
FZD6	confirmed,biallelic
CEP135	probable,biallelic
FGF3	confirmed,biallelic
ISPD	confirmed,biallelic
FAM58A	confirmed,monoallelic
WRAP53	confirmed,biallelic
MAP3K1	confirmed,monoallelic
KRAS	confirmed,monoallelic
CACNB4	child IF,
TBX5	confirmed,monoallelic
MITF	confirmed,monoallelic
MKS1	confirmed,biallelic
CRYBA4	confirmed,monoallelic
FLNB	confirmed,monoallelic
COL9A2	confirmed,biallelic
PEX3	confirmed,biallelic
PAX6	confirmed,monoallelic
CRYAA	confirmed,monoallelic
LRBA	probable,biallelic
KIF5C	probable,monoallelic
EXOSC3	confirmed,biallelic
FANCD2	confirmed,biallelic
AUH	confirmed,biallelic
PEX2	confirmed,biallelic
EXT1	confirmed,monoallelic
DBT	confirmed,biallelic
BCKDHA	confirmed,biallelic
SLC35A1	probable,biallelic
QDPR	confirmed,biallelic
KMT2D	confirmed,monoallelic
HINT1	confirmed,biallelic
UBR1	confirmed,biallelic
GLI3	confirmed,monoallelic
AIRE	both DD and IF,biallelic
CRYGD	possible,monoallelic
ALG6	confirmed,biallelic
HDAC8	confirmed,hemizygous
YY1	probable,monoallelic
SLC17A5	confirmed,biallelic
ERCC4	probable,biallelic
ARID1A	confirmed,monoallelic
MED12	confirmed,hemizygous
ACBD6	possible,biallelic
SRY	confirmed,hemizygous
CRYBA1	confirmed,monoallelic
TP63	confirmed,monoallelic
GDF1	possible,monoallelic
SCN1B	confirmed,monoallelic
HIST3H3	possible,biallelic
RAI1	confirmed,monoallelic
CD96	probable,monoallelic
CSNK1G1	possible,monoallelic
TUBB3	probable,monoallelic
SETD5	confirmed,monoallelic
DDHD2	confirmed,biallelic
CCDC151	probable,biallelic
KCNJ6	probable,monoallelic
TUBGCP4	probable,biallelic
TP63	confirmed,monoallelic
MMP13	confirmed,monoallelic
RPS19	confirmed,monoallelic
GAA	confirmed,biallelic
KIRREL3	possible,monoallelic
CHRNA2	child IF,monoallelic
PTH1R	confirmed,monoallelic
PIK3R2	confirmed,monoallelic
CACNB4	possible,monoallelic
KCTD1	confirmed,monoallelic
ATOH7	possible,biallelic
GFER	possible,biallelic
TBX20	confirmed,monoallelic
TMEM165	confirmed,biallelic
CASK	confirmed,hemizygous
FLNA	confirmed,hemizygous
FAM126A	confirmed,biallelic
HNF1B	confirmed,monoallelic
ELP2	possible,biallelic
MOCS2	confirmed,biallelic
SYNGAP1	confirmed,monoallelic
HR	confirmed,biallelic
PTEN	confirmed,monoallelic
ANKRD26	probable,monoallelic
ALDOB	both DD and IF,biallelic
ATRX	confirmed,hemizygous
IKBKG	confirmed,hemizygous
IRF6	confirmed,monoallelic
SLC12A6	confirmed,biallelic
TP63	confirmed,monoallelic
SLC35A2	confirmed,monoallelic
ABCD1	both DD and IF,hemizygous
SMS	probable,hemizygous
FTCD	confirmed,biallelic
KCNQ2	confirmed,monoallelic
ASPA	confirmed,biallelic
ZNF750	probable,monoallelic
EP300	confirmed,monoallelic
UPF3B	confirmed,hemizygous
SAMHD1	confirmed,biallelic
ASL	confirmed,biallelic
HOXD13	confirmed,monoallelic
STX1B	probable,monoallelic
PEX3	confirmed,biallelic
COL2A1	confirmed,monoallelic
SLC26A2	confirmed,biallelic
GABRA1	probable,monoallelic
MYH8	both DD and IF,monoallelic
LMNA	both DD and IF,monoallelic
SIX5	confirmed,monoallelic
COQ9	confirmed,biallelic
PITX2	confirmed,monoallelic
PPT1	confirmed,biallelic
SLC9A6	confirmed,hemizygous
BRCA2	both DD and IF,biallelic
CENPJ	confirmed,biallelic
NAA10	confirmed,hemizygous
MICU1	confirmed,biallelic
NDUFS1	confirmed,biallelic
AARS	probable,biallelic
EPG5	confirmed,biallelic
ADK	possible,biallelic
LRP4	confirmed,biallelic
SIX1	confirmed,monoallelic
SETBP1	confirmed,monoallelic
KRAS	confirmed,monoallelic
PNPLA2	probable,biallelic
WDR34	confirmed,biallelic
AP4B1	probable,biallelic
CLP1	probable,biallelic
HOXB1	probable,biallelic
MAGI2	possible,monoallelic
ETFA	confirmed,biallelic
CHMP1A	probable,biallelic
COQ5	possible,biallelic
NECTIN1	possible,biallelic
NOTCH1	probable,monoallelic
CBS	confirmed,biallelic
PNPLA1	probable,biallelic
PEX12	confirmed,biallelic
GDF5	confirmed,monoallelic
PIGA	confirmed,hemizygous
NIPBL	confirmed,monoallelic
KCNQ1	confirmed,biallelic
EVC	confirmed,biallelic
BRAF	confirmed,monoallelic
C2orf71	confirmed,biallelic
KCNK9	possible,imprinted
WNT1	confirmed,biallelic
SIK1	confirmed,monoallelic
CA8	confirmed,biallelic
ELAC2	confirmed,biallelic
FKRP	confirmed,biallelic
PTPN11	confirmed,monoallelic
TWIST1	confirmed,monoallelic
SOX10	confirmed,monoallelic
EOGT	confirmed,biallelic
SYNE1	both DD and IF,biallelic
FOXE3	confirmed,monoallelic
GUCY2C	confirmed,biallelic
OBSL1	confirmed,biallelic
SMARCA2	confirmed,monoallelic
FLNA	confirmed,hemizygous
RARB	confirmed,biallelic
RARB	confirmed,monoallelic
MMAB	confirmed,biallelic
RAB39B	confirmed,hemizygous
AXIN1	possible,imprinted
MTHFR	confirmed,biallelic
LARS2	probable,biallelic
HMGCL	confirmed,biallelic
PIK3R1	confirmed,biallelic
ERCC6	confirmed,biallelic
ALDOA	confirmed,biallelic
NAGLU	confirmed,biallelic
WDR73	probable,biallelic
PDHX	confirmed,biallelic
PITX3	confirmed,monoallelic
FGFR3	confirmed,monoallelic
NOTCH2	confirmed,monoallelic
TNFRSF13B	probable,biallelic
PAX6	confirmed,monoallelic
PEX10	confirmed,biallelic
GDF5	confirmed,monoallelic
TWIST1	confirmed,monoallelic
ARSB	confirmed,biallelic
PCGF2	probable,monoallelic
RMND1	probable,biallelic
ANO5	possible,biallelic
PIK3CA	confirmed,mosaic
NHS	confirmed,hemizygous
GABRG2	probable,monoallelic
ROR2	confirmed,monoallelic
COX7B	confirmed,x-linked dominant
FGFR1	confirmed,monoallelic
PEPD	confirmed,biallelic
WDR35	confirmed,biallelic
SLC26A2	confirmed,biallelic
MYH6	both DD and IF,monoallelic
NGLY1	confirmed,biallelic
SC5D	confirmed,biallelic
COL11A2	confirmed,monoallelic
ECEL1	confirmed,biallelic
ALMS1	confirmed,biallelic
GATAD2B	confirmed,monoallelic
ARMC4	confirmed,biallelic
RYR1	confirmed,biallelic
PEX10	confirmed,biallelic
RECQL4	confirmed,biallelic
CIB2	confirmed,biallelic
FGF10	confirmed,monoallelic
KCNT1	confirmed,monoallelic
ABHD5	confirmed,biallelic
GABRB3	confirmed,monoallelic
MATN3	confirmed,monoallelic
MECP2	confirmed,hemizygous
FAR1	confirmed,biallelic
NDUFS7	confirmed,biallelic
CTNS	confirmed,biallelic
GMPPB	confirmed,biallelic
CYC1	confirmed,biallelic
P4HB	probable,monoallelic
ANKH	confirmed,monoallelic
PEX6	confirmed,biallelic
WDR45B	possible,biallelic
TRIM32	confirmed,biallelic
ACO2	probable,biallelic
GNPTG	confirmed,biallelic
MECP2	confirmed,hemizygous
TTC7A	confirmed,biallelic
RGS7	possible,biallelic
PGK1	confirmed,hemizygous
NAGA	confirmed,biallelic
CLCNKA	possible,biallelic
FANCA	confirmed,biallelic
LEFTY2	possible,monoallelic
FAM20A	confirmed,biallelic
ACY1	confirmed,biallelic
EXT1	confirmed,monoallelic
NOG	confirmed,monoallelic
PROP1	confirmed,biallelic
GTPBP3	confirmed,biallelic
PTCHD1	confirmed,hemizygous
ACSL4	probable,hemizygous
MED12	confirmed,hemizygous
ITGA3	confirmed,biallelic
DPAGT1	confirmed,biallelic
AGTR2	possible,hemizygous
CC2D2A	confirmed,biallelic
DDR2	confirmed,biallelic
LARGE1	confirmed,biallelic
MYO5B	confirmed,biallelic
ZBTB40	possible,biallelic
SLC16A2	confirmed,hemizygous
BHLHA9	confirmed,biallelic
HSD17B4	confirmed,biallelic
HPRT1	confirmed,hemizygous
ZMYND10	probable,biallelic
GLI3	confirmed,monoallelic
KCNH5	possible,monoallelic
ASXL3	probable,monoallelic
KCTD7	confirmed,biallelic
DAG1	confirmed,biallelic
COL11A2	confirmed,biallelic
KCNT1	confirmed,monoallelic
ALG13	probable,hemizygous
ABCB7	confirmed,hemizygous
PTH1R	confirmed,monoallelic
CTC1	confirmed,biallelic
KCNE1	child IF,monoallelic
GDF3	possible,monoallelic
FGFR2	confirmed,monoallelic
CLMP	probable,biallelic
FAH	confirmed,biallelic
CEP290	confirmed,biallelic
SMC1A	confirmed,x-linked dominant
CENPJ	confirmed,biallelic
COMP	confirmed,monoallelic
PRPS1	confirmed,hemizygous
CHST14	confirmed,biallelic
CRYBB3	confirmed,biallelic
IHH	confirmed,monoallelic
CDON	confirmed,monoallelic
DYNC2H1	confirmed,biallelic
FGFR3	confirmed,monoallelic
LAMA1	confirmed,biallelic
GBA	both DD and IF,biallelic
FUCA1	confirmed,biallelic
CACNA1C	confirmed,monoallelic
ELN	confirmed,monoallelic
TRIP11	confirmed,biallelic
HOXD13	confirmed,monoallelic
COL4A3	confirmed,biallelic
IDS	confirmed,hemizygous
SPRED1	confirmed,monoallelic
TGIF1	confirmed,monoallelic
BCS1L	confirmed,biallelic
AIPL1	confirmed,biallelic
PEX5	confirmed,biallelic
PHF6	confirmed,hemizygous
CCDC114	confirmed,biallelic
KIF1A	confirmed,monoallelic
FAM20C	confirmed,biallelic
GRM6	confirmed,biallelic
SNRPE	probable,monoallelic
RAF1	confirmed,monoallelic
KIF1A	confirmed,biallelic
KIF1A	confirmed,biallelic
SRD5A3	confirmed,biallelic
IGF1R	confirmed,biallelic
IGF1R	confirmed,monoallelic
IARS2	possible,biallelic
CAPN10	possible,biallelic
FAM161A	both DD and IF,biallelic
MID1	confirmed,hemizygous
PNPT1	confirmed,biallelic
NRXN1	probable,biallelic
PLCE1	confirmed,biallelic
VLDLR	confirmed,biallelic
MEF2C	confirmed,monoallelic
SOBP	possible,biallelic
MSX2	confirmed,monoallelic
ZNF599	possible,monoallelic
NLGN4X	possible,hemizygous
ALDH7A1	confirmed,biallelic
WT1	confirmed,monoallelic
NMNAT1	confirmed,biallelic
TUBB4A	confirmed,monoallelic
POMT2	confirmed,biallelic
AK2	confirmed,biallelic
HSD3B7	confirmed,biallelic
EGR2	confirmed,biallelic
ZMYM6	possible,monoallelic
PTPN11	confirmed,monoallelic
SIX6	possible,monoallelic
CC2D2A	confirmed,biallelic
WDR19	confirmed,biallelic
IGSF1	confirmed,hemizygous
SOX10	confirmed,monoallelic
ERCC6L2	confirmed,biallelic
CEP57	confirmed,biallelic
HPSE2	confirmed,biallelic
IFT172	confirmed,biallelic
NLGN3	probable,hemizygous
IRX5	probable,biallelic
KIF7	confirmed,biallelic
LMBRD1	confirmed,biallelic
RMRP	confirmed,biallelic
LAMP2	confirmed,hemizygous
GAD1	possible,biallelic
HNF4A	confirmed,monoallelic
LTBP2	confirmed,biallelic
COL1A1	confirmed,monoallelic
TP63	confirmed,monoallelic
MAPK10	possible,monoallelic
SLC26A2	confirmed,biallelic
OTX2	confirmed,monoallelic
UQCRQ	probable,biallelic
FGFR2	confirmed,monoallelic
NSDHL	confirmed,x-linked dominant
GJB3	both DD and IF,biallelic
ERCC6	confirmed,biallelic
DIP2B	possible,monoallelic
KIF7	confirmed,biallelic
GATA2	confirmed,monoallelic
SDHAF1	confirmed,biallelic
FBN1	confirmed,monoallelic
FBN1	confirmed,biallelic
ATP8B1	confirmed,biallelic
FIG4	probable,biallelic
SECISBP2	probable,biallelic
MTMR14	possible,digenic
MAN2B1	confirmed,biallelic
RAD51C	probable,biallelic
FOXG1	confirmed,monoallelic
CCNA2	possible,biallelic
TWIST2	probable,biallelic
ADNP	confirmed,monoallelic
PEX2	confirmed,biallelic
NDUFAF2	probable,biallelic
MECP2	confirmed,hemizygous
RPGRIP1	confirmed,biallelic
IGBP1	possible,hemizygous
GCH1	confirmed,biallelic
TRPV4	confirmed,monoallelic
LIG4	confirmed,biallelic
MYH9	confirmed,monoallelic
COA5	possible,biallelic
MYH9	confirmed,monoallelic
COL25A1	probable,biallelic
POLR1C	confirmed,biallelic
KCNH1	probable,monoallelic
GNAS	confirmed,monoallelic
ARID1B	confirmed,monoallelic
IFIH1	confirmed,monoallelic
SIX3	confirmed,monoallelic
CHRNA4	confirmed,monoallelic
PCDH19	confirmed,x-linked over-dominance
TBX4	confirmed,monoallelic
MSX2	confirmed,monoallelic
LTBP2	confirmed,biallelic
MKS1	confirmed,biallelic
PLP1	confirmed,hemizygous
GNPTAB	confirmed,biallelic
HEXA	confirmed,biallelic
ATP6V1B1	confirmed,biallelic
RSPH1	confirmed,biallelic
SMAD4	confirmed,monoallelic
C5orf42	confirmed,biallelic
ALX4	confirmed,biallelic
SCO2	confirmed,biallelic
LARGE1	confirmed,biallelic
MAF	confirmed,monoallelic
CCNO	confirmed,biallelic
ERCC2	confirmed,biallelic
RAPSN	confirmed,biallelic
NALCN	confirmed,biallelic
WDPCP	confirmed,biallelic
ALX3	confirmed,biallelic
CACNB4	possible,
FREM1	confirmed,biallelic
CKAP2L	confirmed,biallelic
ATP1A3	both DD and IF,monoallelic
PEX14	confirmed,biallelic
MITF	confirmed,monoallelic
UBE3A	confirmed,imprinted
POLR3B	confirmed,biallelic
SEC23A	possible,biallelic
WNT5A	confirmed,monoallelic
MAMLD1	probable,hemizygous
NF1	confirmed,monoallelic
POMT2	confirmed,biallelic
STT3A	possible,biallelic
UBE3B	confirmed,biallelic
PTEN	confirmed,monoallelic
JAK3	confirmed,biallelic
AP4S1	probable,biallelic
COX10	confirmed,biallelic
PEX2	confirmed,biallelic
ALG3	confirmed,biallelic
SLC17A5	confirmed,biallelic
KIF2A	probable,monoallelic
NDE1	confirmed,biallelic
KANSL1	confirmed,monoallelic
COL11A2	confirmed,monoallelic
WDR11	confirmed,monoallelic
ALDH1A3	confirmed,biallelic
THAP1	both DD and IF,monoallelic
SOS1	confirmed,monoallelic
HAX1	confirmed,biallelic
COX14	possible,biallelic
ITGA7	confirmed,biallelic
TSPAN7	confirmed,hemizygous
CHD7	confirmed,monoallelic
MYOC	possible,monoallelic
CASP2	possible,biallelic
MBD5	possible,monoallelic
GCH1	confirmed,monoallelic
RPE65	confirmed,biallelic
CUL4B	confirmed,hemizygous
RASA1	confirmed,monoallelic
TMCO1	confirmed,biallelic
FGFR2	confirmed,monoallelic
NOG	confirmed,monoallelic
AKT3	probable,mosaic
PEX19	confirmed,biallelic
FOLR1	confirmed,biallelic
PAPSS2	confirmed,biallelic
ASAH1	confirmed,biallelic
TRIO	probable,monoallelic
ASH1L	possible,monoallelic
SDHA	confirmed,biallelic
GBA	both DD and IF,biallelic
TSHR	confirmed,biallelic
COL9A3	confirmed,monoallelic
FGFR3	confirmed,monoallelic
GRIA3	confirmed,hemizygous
PHIP	possible,monoallelic
ERCC5	confirmed,biallelic
TSC2	confirmed,monoallelic
PTH1R	confirmed,biallelic
NPHP1	confirmed,biallelic
HSD17B10	confirmed,hemizygous
VDR	confirmed,biallelic
PRSS56	confirmed,biallelic
TUFM	probable,biallelic
GRIN1	confirmed,monoallelic
NF1	confirmed,monoallelic
PIGT	confirmed,biallelic
MIR184	possible,monoallelic
LMNA	both DD and IF,monoallelic
SPG11	confirmed,biallelic
TGFBR1	confirmed,monoallelic
HPRT1	confirmed,hemizygous
TYRP1	confirmed,biallelic
SMAD4	both DD and IF,monoallelic
PAK3	confirmed,hemizygous
FBN1	confirmed,monoallelic
CSPP1	confirmed,biallelic
EMX2	possible,monoallelic
LIG4	confirmed,biallelic
ALG2	probable,biallelic
PAX6	confirmed,monoallelic
TACO1	probable,biallelic
FLNB	confirmed,monoallelic
TUBB3	probable,monoallelic
CCND2	confirmed,monoallelic
TTC37	confirmed,biallelic
P3H1	confirmed,biallelic
SOX2	confirmed,monoallelic
PAX6	confirmed,monoallelic
GNAI3	confirmed,monoallelic
STXBP1	confirmed,monoallelic
ALDH4A1	confirmed,biallelic
CHRNA2	possible,
CRYBA4	possible,monoallelic
CRYGC	possible,monoallelic
RBPJ	probable,monoallelic
GPR179	confirmed,biallelic
TBCE	confirmed,biallelic
MTM1	confirmed,hemizygous
AFG3L2	child IF,biallelic
ERBB3	possible,biallelic
CTDP1	confirmed,biallelic
LFNG	confirmed,biallelic
EVC2	confirmed,biallelic
CA5A	probable,biallelic
MAN1B1	confirmed,biallelic
LONP1	probable,biallelic
PIK3CA	confirmed,mosaic
NSMCE3	possible,biallelic
CRELD1	probable,monoallelic
PNPT1	confirmed,biallelic
ACAD9	confirmed,biallelic
SPR	confirmed,biallelic
GABBR2	possible,monoallelic
POMT1	confirmed,biallelic
SMOC2	probable,biallelic
MCEE	confirmed,biallelic
CNKSR2	probable,hemizygous
EDN1	probable,monoallelic
EDN1	probable,biallelic
ATIC	confirmed,biallelic
AP4E1	confirmed,biallelic
ESCO2	confirmed,biallelic
LMNA	both DD and IF,monoallelic
NDUFS4	confirmed,biallelic
ERMARD	possible,monoallelic
KPTN	probable,biallelic
CPS1	confirmed,biallelic
CHRNB2	probable,monoallelic
INPPL1	confirmed,biallelic
MC2R	confirmed,biallelic
GLB1	confirmed,biallelic
DYRK1A	confirmed,monoallelic
ACTA1	probable,biallelic
PREPL	probable,biallelic
DDX58	possible,monoallelic
DECR1	probable,biallelic
POMGNT2	confirmed,biallelic
TM4SF20	possible,monoallelic
COL4A3BP	confirmed,monoallelic
GNAS	confirmed,monoallelic
AKT1	confirmed,mosaic
PITX1	probable,monoallelic
COL2A1	confirmed,monoallelic
PITX2	confirmed,monoallelic
LAMB1	probable,biallelic
PTF1A	confirmed,biallelic
BCKDHB	confirmed,biallelic
TAZ	confirmed,hemizygous
ALX4	confirmed,monoallelic
MTR	confirmed,biallelic
STAT1	confirmed,biallelic
MYCN	confirmed,monoallelic
ACP5	confirmed,biallelic
FTSJ1	confirmed,hemizygous
GBA2	confirmed,biallelic
IL1RAPL1	confirmed,hemizygous
ST3GAL5	probable,biallelic
RBM8A	confirmed,biallelic
SRGAP3	possible,monoallelic
KCNJ10	confirmed,biallelic
SHH	confirmed,monoallelic
PLOD2	confirmed,biallelic
FANCM	probable,biallelic
COL18A1	confirmed,biallelic
COG4	confirmed,biallelic
TYR	confirmed,biallelic
GDF1	possible,monoallelic
LRP5	confirmed,monoallelic
IGHMBP2	confirmed,biallelic
TUBA1A	confirmed,monoallelic
KLF1	confirmed,monoallelic
MLC1	confirmed,biallelic
CRB1	confirmed,biallelic
TGFB2	both DD and IF,monoallelic
DNAAF5	probable,biallelic
NOP10	possible,
NOG	confirmed,monoallelic
RYR3	possible,monoallelic
ACSL4	probable,hemizygous
TGFBR1	confirmed,monoallelic
TRAPPC11	probable,biallelic
PTEN	confirmed,mosaic
FGFR3	confirmed,monoallelic
SPEG	confirmed,biallelic
HIBCH	confirmed,biallelic
SCO1	confirmed,biallelic
LHX3	confirmed,biallelic
NHP2	probable,biallelic
CACNB4	possible,
UROS	confirmed,biallelic
HSPG2	confirmed,biallelic
SHANK2	probable,monoallelic
IDUA	confirmed,biallelic
NEB	possible,biallelic
L2HGDH	confirmed,biallelic
SETBP1	confirmed,monoallelic
SMPD1	confirmed,biallelic
FGF9	probable,monoallelic
FANCM	probable,biallelic
RAB3GAP2	confirmed,biallelic
TGDS	confirmed,biallelic
LBR	confirmed,biallelic
SEC23B	confirmed,biallelic
MTOR	possible,mosaic
SOX10	confirmed,monoallelic
HOXA13	confirmed,monoallelic
SOX3	confirmed,hemizygous
SLC27A4	confirmed,biallelic
ALDH3A2	confirmed,biallelic
PAX3	confirmed,monoallelic
TBX22	confirmed,hemizygous
HPS1	confirmed,biallelic
GK	confirmed,hemizygous
TUBB2B	confirmed,monoallelic
RPGRIP1L	confirmed,biallelic
CCDC103	confirmed,biallelic
HR	confirmed,biallelic
STT3B	possible,biallelic
CLPB	confirmed,biallelic
LRP5	confirmed,monoallelic
DMD	confirmed,hemizygous
RBM10	probable,hemizygous
EFTUD2	confirmed,monoallelic
NOG	confirmed,monoallelic
FASN	possible,biallelic
PITX3	confirmed,monoallelic
MMP13	confirmed,biallelic
POLR3B	confirmed,biallelic
APTX	confirmed,biallelic
MCCC1	confirmed,biallelic
SLC35D1	confirmed,biallelic
SLC26A2	confirmed,biallelic
NPHP1	confirmed,biallelic
PMS2	confirmed,biallelic
TAB2	confirmed,monoallelic
PEX16	confirmed,biallelic
LTBP3	confirmed,biallelic
PHGDH	confirmed,biallelic
ZCCHC8	possible,biallelic
KDM6B	possible,biallelic
COL11A2	confirmed,monoallelic
GJA8	confirmed,monoallelic
IFT80	confirmed,biallelic
FKBP14	confirmed,biallelic
FOXC2	confirmed,monoallelic
LINS1	probable,biallelic
DLD	confirmed,biallelic
FGFR3	confirmed,monoallelic
CRYGD	confirmed,monoallelic
PAX8	confirmed,monoallelic
PSPH	confirmed,biallelic
ENPP1	confirmed,biallelic
PDE4D	confirmed,monoallelic
EVC2	confirmed,biallelic
PTEN	confirmed,monoallelic
TRAPPC9	confirmed,biallelic
CTNNB1	confirmed,monoallelic
ZNF713	possible,monoallelic
KDM5C	confirmed,hemizygous
FLT4	confirmed,monoallelic
SMAD2	possible,monoallelic
CACNA1G	possible,biallelic
PEX1	confirmed,biallelic
MPV17	confirmed,biallelic
TSC1	confirmed,monoallelic
PNKP	confirmed,biallelic
ALG13	probable,hemizygous
SEC24D	probable,biallelic
FGFR2	confirmed,monoallelic
SYN1	probable,hemizygous
L1CAM	confirmed,hemizygous
MKKS	confirmed,biallelic
CCDC22	probable,hemizygous
SKI	confirmed,monoallelic
DGAT1	possible,biallelic
SHOX	confirmed,monoallelic
CDH23	confirmed,biallelic
DCHS1	confirmed,biallelic
POLR1D	confirmed,monoallelic
GDF6	confirmed,monoallelic
SURF1	confirmed,biallelic
PLCG2	possible,monoallelic
ACVR1	probable,monoallelic
PEX1	confirmed,biallelic
PHOX2B	confirmed,monoallelic
ST14	probable,biallelic
PLA2G6	both DD and IF,biallelic
BRWD3	confirmed,hemizygous
WDR62	confirmed,biallelic
MYT1L	possible,monoallelic
PEX10	confirmed,biallelic
PPP2R5D	confirmed,monoallelic
B9D1	probable,biallelic
ERCC8	confirmed,biallelic
COL4A2	both DD and IF,monoallelic
DKC1	confirmed,hemizygous
NPC1	confirmed,biallelic
GJA3	confirmed,monoallelic
FLNA	confirmed,x-linked dominant
DPM1	confirmed,biallelic
DLG3	confirmed,hemizygous
STAR	confirmed,biallelic
GALE	confirmed,biallelic
GLI3	confirmed,monoallelic
MMACHC	confirmed,biallelic
FYCO1	confirmed,biallelic
BBS2	confirmed,biallelic
APOPT1	confirmed,biallelic
FBXL4	confirmed,biallelic
FBP1	confirmed,biallelic
AGXT	both DD and IF,biallelic
C21orf59	probable,biallelic
TUSC3	confirmed,biallelic
TSEN2	probable,biallelic
LRIG2	probable,biallelic
SNIP1	possible,biallelic
GDF3	possible,monoallelic
PCYT1A	confirmed,biallelic
ZSWIM6	probable,monoallelic
NPHP1	confirmed,biallelic
MAP2K2	confirmed,monoallelic
CAPRIN1	possible,monoallelic
MMP14	possible,biallelic
PRPS1	confirmed,hemizygous
TAF2	possible,biallelic
GDF5	confirmed,monoallelic
FGFR3	confirmed,monoallelic
RAB23	confirmed,biallelic
TMPRSS6	confirmed,biallelic
GATA6	confirmed,monoallelic
HMGCS2	confirmed,biallelic
ASS1	confirmed,biallelic
POLG	confirmed,biallelic
VPS33B	confirmed,biallelic
DCDC2	probable,biallelic
RNASET2	confirmed,biallelic
MGP	confirmed,biallelic
PITX1	probable,monoallelic
PLA2G6	both DD and IF,biallelic
TCOF1	confirmed,monoallelic
ERCC2	confirmed,biallelic
DOCK7	probable,biallelic
AIMP1	probable,biallelic
EDA	confirmed,hemizygous
HDAC4	confirmed,monoallelic
CRBN	possible,biallelic
FMR1	both DD and IF,x-linked dominant
PEX26	confirmed,biallelic
MYH3	confirmed,monoallelic
HOXD13	confirmed,monoallelic
LMNA	both DD and IF,monoallelic
COL2A1	possible,monoallelic
SYNGAP1	confirmed,monoallelic
ROGDI	confirmed,biallelic
ERCC3	confirmed,biallelic
GJB2	confirmed,monoallelic
NRAS	confirmed,monoallelic
NBN	confirmed,biallelic
LMX1B	confirmed,monoallelic
POMT1	confirmed,biallelic
LMNA	both DD and IF,monoallelic
COL2A1	confirmed,monoallelic
GBA	both DD and IF,biallelic
DLD	confirmed,biallelic
ACAT1	confirmed,biallelic
TSHB	confirmed,biallelic
GJB2	confirmed,monoallelic
COX15	confirmed,biallelic
NPHP3	confirmed,biallelic
KDM5A	possible,biallelic
PDE6H	probable,biallelic
DIS3L2	confirmed,biallelic
GTF2H5	confirmed,biallelic
COL9A2	confirmed,monoallelic
HYAL1	confirmed,biallelic
HCFC1	confirmed,hemizygous
IHH	confirmed,biallelic
NKX2-5	confirmed,monoallelic
RNF168	possible,biallelic
CEP83	confirmed,biallelic
SHH	confirmed,monoallelic
ITPR1	probable,monoallelic
WAC	confirmed,monoallelic
CHD8	probable,monoallelic
CYP1B1	confirmed,biallelic
SF3B4	confirmed,monoallelic
HNRNPU	confirmed,monoallelic
ATP8A2	possible,biallelic
BTD	confirmed,biallelic
SYP	confirmed,hemizygous
UROC1	confirmed,biallelic
IGFBP7	probable,biallelic
IVD	confirmed,biallelic
LRIT3	probable,biallelic
SIL1	confirmed,biallelic
KARS	both DD and IF,biallelic
SOX5	probable,monoallelic
ANO5	both DD and IF,monoallelic
PORCN	confirmed,x-linked dominant
TGFBR2	confirmed,monoallelic
FKTN	confirmed,biallelic
NAA15	probable,monoallelic
BBS7	confirmed,biallelic
PTH	probable,biallelic
ETHE1	confirmed,biallelic
CTSK	confirmed,biallelic
COL3A1	child IF,monoallelic
CCDC8	probable,biallelic
LIPN	probable,biallelic
SLC24A1	possible,biallelic
ATM	confirmed,biallelic
PRPS1	confirmed,hemizygous
ERCC4	probable,biallelic
TMEM70	confirmed,biallelic
MECP2	confirmed,hemizygous
PHOX2B	confirmed,monoallelic
STAT1	confirmed,monoallelic
PGM1	confirmed,biallelic
NEK1	confirmed,biallelic
NEK1	confirmed,digenic
KCTD7	confirmed,biallelic
FOXP1	confirmed,monoallelic
SMARCAL1	confirmed,biallelic
CHD7	confirmed,monoallelic
SPECC1L	probable,monoallelic
DHCR7	confirmed,biallelic
PNKP	confirmed,biallelic
RSPH3	confirmed,biallelic
ITPR1	probable,monoallelic
LARP7	confirmed,biallelic
KMT2A	confirmed,monoallelic
CYB5R3	probable,biallelic
KCNJ11	confirmed,monoallelic
KCNJ11	confirmed,monoallelic
CRADD	possible,biallelic
PHF8	confirmed,hemizygous
ARSE	confirmed,hemizygous
GRM1	probable,biallelic
STIL	probable,biallelic
TP63	confirmed,monoallelic
PIGN	probable,biallelic
MAF	confirmed,monoallelic
BIN1	confirmed,biallelic
DARS	confirmed,biallelic
SRPX2	probable,hemizygous
NPHP3	confirmed,biallelic
FKTN	confirmed,biallelic
CDKN1C	confirmed,imprinted
CDH3	confirmed,biallelic
CHD2	confirmed,monoallelic
CHM	confirmed,hemizygous
IKBKG	confirmed,hemizygous
TSHR	confirmed,monoallelic
PTCH1	confirmed,monoallelic
ERCC1	confirmed,biallelic
POC1A	confirmed,biallelic
BMPR1B	confirmed,biallelic
PEX5	confirmed,biallelic
MAF	confirmed,monoallelic
MUT	confirmed,biallelic
PSAT1	probable,biallelic
PDE6H	probable,biallelic
TMEM67	confirmed,biallelic
TSHZ1	possible,monoallelic
GRIN2A	confirmed,monoallelic
PACS1	probable,monoallelic
FANCI	confirmed,biallelic
SHH	confirmed,monoallelic
GSPT2	probable,hemizygous
GLIS3	confirmed,biallelic
RNF113A	possible,hemizygous
PPP2R1A	confirmed,monoallelic
ADAR	confirmed,biallelic
ADAR	confirmed,monoallelic
KIF4A	possible,hemizygous
MAOA	probable,hemizygous
MEGF8	confirmed,biallelic
SKIV2L	confirmed,biallelic
BBS12	confirmed,biallelic
GABRA1	probable,monoallelic
C4orf26	confirmed,biallelic
SMARCA4	confirmed,monoallelic
AFF4	confirmed,monoallelic
IFITM5	confirmed,monoallelic
NPC2	confirmed,biallelic
SLC9A9	possible,monoallelic
NDUFS1	confirmed,biallelic
CIC	possible,monoallelic
EIF4A3	confirmed,biallelic
CRYGD	confirmed,monoallelic
CACNA1H	possible,monoallelic
ST3GAL3	probable,biallelic
KCNQ2	confirmed,monoallelic
CLCN4	possible,monoallelic
MAB21L2	confirmed,monoallelic
MAB21L2	confirmed,biallelic
ATP6AP2	possible,hemizygous
CEP152	confirmed,biallelic
SMAD4	both DD and IF,monoallelic
SLC33A1	confirmed,biallelic
FGD1	confirmed,hemizygous
PRMT9	possible,biallelic
HPGD	confirmed,biallelic
COL2A1	confirmed,monoallelic
PEX7	confirmed,biallelic
COQ8A	confirmed,biallelic
XPA	confirmed,biallelic
TDRD7	possible,biallelic
TTI2	probable,biallelic
NODAL	confirmed,monoallelic
FIG4	probable,biallelic
BLM	confirmed,biallelic
TMEM135	possible,biallelic
GABRG2	probable,monoallelic
MEOX1	probable,biallelic
SIX1	confirmed,monoallelic
NKX2-1	confirmed,monoallelic
IL11	possible,biallelic
AMT	confirmed,biallelic
XPNPEP3	possible,biallelic
CUL7	confirmed,biallelic
CTSD	confirmed,biallelic
RPGRIP1L	confirmed,biallelic
SCN1B	confirmed,monoallelic
RAB3GAP1	confirmed,biallelic
EDNRB	confirmed,monoallelic
SLC2A1	confirmed,monoallelic
COMP	confirmed,monoallelic
SDCCAG8	confirmed,biallelic
NPHP3	confirmed,biallelic
NFIX	confirmed,monoallelic
PTCH1	confirmed,monoallelic
ACAN	confirmed,biallelic
ATP6V1B2	probable,monoallelic
PQBP1	confirmed,hemizygous
MCPH1	confirmed,biallelic
KIAA2022	probable,hemizygous
LMNA	both DD and IF,monoallelic
SPAG1	confirmed,biallelic
GLE1	confirmed,biallelic
LMNA	both DD and IF,monoallelic
ZFPM2	possible,monoallelic
CCDC39	confirmed,biallelic
NUBPL	confirmed,biallelic
NHS	confirmed,hemizygous
MYH9	confirmed,monoallelic
ITGA6	possible,monoallelic
GPC6	probable,biallelic
POMP	possible,biallelic
MYO5A	confirmed,biallelic
EZH2	confirmed,monoallelic
PTH1R	confirmed,biallelic
GLMN	confirmed,monoallelic
FOXC2	confirmed,monoallelic
COL4A4	confirmed,biallelic
TK2	confirmed,biallelic
ETFB	confirmed,biallelic
GJA1	possible,monoallelic
PLXND1	possible,biallelic
UTP4	possible,biallelic
GJA1	confirmed,biallelic
TXNL4A	confirmed,biallelic
ERCC4	confirmed,biallelic
COL2A1	confirmed,monoallelic
IFIH1	probable,monoallelic
ITGA8	probable,biallelic
ORC6	confirmed,biallelic
POU1F1	confirmed,biallelic
FOXC1	confirmed,monoallelic
PDHA1	confirmed,hemizygous
COL11A1	confirmed,monoallelic
ENTPD1	possible,biallelic
ERCC1	confirmed,biallelic
EFNB1	confirmed,x-linked over-dominance
CC2D1A	confirmed,biallelic
UBR7	possible,biallelic
FKTN	confirmed,biallelic
DDX59	probable,biallelic
NDUFB11	probable,x-linked dominant
MYH8	both DD and IF,monoallelic
GM2A	confirmed,biallelic
MCOLN1	confirmed,biallelic
ERF	confirmed,monoallelic
EDNRA	confirmed,monoallelic
PEX7	confirmed,biallelic
FBN1	possible,monoallelic
DYM	confirmed,biallelic
TRIM37	confirmed,biallelic
AKR1D1	confirmed,biallelic
DMD	confirmed,hemizygous
RANBP2	possible,monoallelic
SCRIB	possible,monoallelic
PGAP3	confirmed,biallelic
SPTLC2	both DD and IF,monoallelic
HIST1H4B	possible,biallelic
ACADVL	confirmed,biallelic
PCCB	confirmed,biallelic
FOXP3	confirmed,hemizygous
HSF4	confirmed,monoallelic
NOTCH3	possible,monoallelic
TP63	confirmed,monoallelic
BSND	confirmed,biallelic
COX6B1	confirmed,biallelic
PUF60	possible,monoallelic
SMARCB1	confirmed,monoallelic
PALB2	confirmed,biallelic
SOX9	confirmed,monoallelic
TBC1D24	confirmed,biallelic
COL3A1	child IF,monoallelic
WDR34	confirmed,biallelic
VIP	possible,monoallelic
PGM3	confirmed,biallelic
IKBKG	confirmed,hemizygous
SUCLG1	confirmed,biallelic
LRP5	confirmed,biallelic
PAX6	confirmed,monoallelic
INPP4A	possible,biallelic
PAK3	confirmed,hemizygous
SLC31A1	possible,biallelic
FANCI	confirmed,biallelic
CSTB	confirmed,biallelic
DSPP	confirmed,monoallelic
TH	confirmed,biallelic
FBN1	possible,monoallelic
MAGT1	possible,hemizygous
CCDC65	confirmed,biallelic
POMGNT1	confirmed,biallelic
DRC1	probable,biallelic
RAD50	possible,biallelic
FBN1	confirmed,monoallelic
RNASEH2C	confirmed,biallelic
WNT4	probable,monoallelic
CCDC40	confirmed,biallelic
GUCY2C	confirmed,monoallelic
PYCR2	probable,biallelic
COX10	confirmed,biallelic
COL4A3	confirmed,monoallelic
GDF5	confirmed,biallelic
FANCL	probable,biallelic
SBDS	confirmed,biallelic
RTTN	probable,biallelic
IGF1	confirmed,biallelic
TRPV4	confirmed,monoallelic
FRAS1	confirmed,biallelic
SNX14	confirmed,biallelic
PDGFRB	confirmed,monoallelic
NSD1	confirmed,monoallelic
SPRTN	possible,biallelic
SALL4	confirmed,monoallelic
FBXO25	possible,monoallelic
FGFR2	confirmed,monoallelic
GATM	confirmed,biallelic
AHDC1	confirmed,monoallelic
DDOST	confirmed,biallelic
ENPP1	confirmed,biallelic
RAB18	confirmed,biallelic
HNF4A	confirmed,monoallelic
NDUFS4	confirmed,biallelic
CHRNA1	probable,biallelic
PAX6	confirmed,monoallelic
MFRP	confirmed,biallelic
ANKH	confirmed,monoallelic
CDKL5	confirmed,x-linked dominant
KCNB1	confirmed,monoallelic
PSAP	confirmed,biallelic
GMPPA	confirmed,biallelic
EEF1A2	probable,monoallelic
TPP1	confirmed,biallelic
GJA1	confirmed,monoallelic
PIEZO2	confirmed,monoallelic
SMCHD1	possible,digenic
ZBTB20	confirmed,monoallelic
CASK	confirmed,hemizygous
CEP290	confirmed,biallelic
EOMES	possible,biallelic
VIPAS39	confirmed,biallelic
CISD2	both DD and IF,biallelic
NR5A1	both DD and IF,monoallelic
SCN8A	confirmed,monoallelic
DDX11	confirmed,biallelic
TSEN54	confirmed,biallelic
KAT6B	confirmed,monoallelic
FOXRED1	confirmed,biallelic
GJB2	confirmed,monoallelic
POLR1A	probable,monoallelic
GALNS	confirmed,biallelic
HCFC1	confirmed,hemizygous
COG8	confirmed,biallelic
CRYBB2	confirmed,monoallelic
PLOD1	confirmed,biallelic
POC1A	confirmed,biallelic
UQCRB	probable,biallelic
CLN8	confirmed,biallelic
SHANK1	probable,monoallelic
DMD	confirmed,hemizygous
HYDIN	confirmed,biallelic
TIMM8A	both DD and IF,hemizygous
TCTN3	confirmed,biallelic
KIF22	confirmed,monoallelic
NDUFA1	confirmed,hemizygous
GLIS2	probable,biallelic
ASXL1	confirmed,monoallelic
TBR1	probable,monoallelic
CLN5	confirmed,biallelic
DYNC1H1	confirmed,monoallelic
LEMD3	confirmed,monoallelic
DCX	confirmed,hemizygous
NOTCH1	probable,monoallelic
CREBBP	confirmed,monoallelic
GPC3	confirmed,hemizygous
SHOC2	confirmed,monoallelic
SLC39A13	confirmed,biallelic
ZIC3	confirmed,hemizygous
TSC2	confirmed,monoallelic
EIF2AK3	confirmed,biallelic
ACTG1	confirmed,monoallelic
CLN6	both DD and IF,biallelic
GDF5	confirmed,monoallelic
RECQL4	confirmed,biallelic
AIFM1	probable,hemizygous
PAH	confirmed,biallelic
PSAT1	probable,biallelic
HLCS	confirmed,biallelic
ZMYND11	probable,monoallelic
USB1	confirmed,biallelic
STAT2	possible,biallelic
RIN2	probable,biallelic
HACE1	confirmed,biallelic
KIAA0586	confirmed,biallelic
MMP21	confirmed,biallelic
PRMT7	confirmed,biallelic
SCN3A	probable,monoallelic
AHI1	confirmed,biallelic
TUBB	confirmed,monoallelic
MAPRE2	confirmed,biallelic
MECOM	probable,monoallelic
HOXA11	possible,monoallelic
SCYL1	probable,biallelic
COL13A1	probable,biallelic
SLC39A8	confirmed,biallelic
GMNN	probable,monoallelic
TAF1	confirmed,hemizygous
DKC1	confirmed,hemizygous
TERT	confirmed,biallelic
PARN	confirmed,biallelic
TINF2	confirmed,monoallelic
TPM2	probable,monoallelic
TCN2	confirmed,biallelic
CLIC2	possible,hemizygous
TERC	child IF,monoallelic
TRAIP	probable,biallelic
COL6A3	confirmed,biallelic
COL6A3	confirmed,biallelic
ADGRG6	confirmed,biallelic
XYLT2	probable,biallelic
SPARC	probable,biallelic
UBE2T	probable,biallelic
TBX18	probable,monoallelic
THOC2	probable,hemizygous
ZIC1	confirmed,monoallelic
SPATA5	confirmed,biallelic
PDGFRB	confirmed,monoallelic
DLL4	confirmed,monoallelic
ALDH18A1	confirmed,monoallelic
TAPT1	probable,biallelic
GAS8	confirmed,biallelic
NUP107	confirmed,biallelic
RSPRY1	probable,biallelic
MAGEL2	probable,imprinted
SLC25A26	confirmed,biallelic
RTN4IP1	confirmed,biallelic
CEP104	confirmed,biallelic
KITLG	possible,monoallelic
MFSD2A	confirmed,biallelic
PRDM12	confirmed,biallelic
CRIPT	possible,biallelic
D2HGDH	possible,biallelic
CNTNAP1	probable,biallelic
DSE	possible,biallelic
WDR81	possible,biallelic
CCDC88C	probable,biallelic
NDUFA10	probable,biallelic
NDUFA9	possible,biallelic
PIGW	possible,biallelic
GPX4	probable,biallelic
CNOT3	confirmed,monoallelic
CSNK2A1	confirmed,monoallelic
GNAI1	confirmed,monoallelic
KCNQ3	confirmed,monoallelic
KDM5B	confirmed,monoallelic
MSL3	confirmed,x-linked dominant
MYT1L	confirmed,monoallelic
PPM1D	confirmed,monoallelic
PUF60	confirmed,monoallelic
QRICH1	confirmed,monoallelic
SET	probable,monoallelic
KMT5B	confirmed,monoallelic
TCF20	confirmed,monoallelic
ZBTB18	confirmed,monoallelic
WAC	confirmed,monoallelic
SCN2A	confirmed,monoallelic
UNC80	confirmed,biallelic
CCDC115	confirmed,biallelic
TMEM199	child IF,biallelic
TANGO2	confirmed,biallelic
TRIP4	probable,biallelic
ASCC1	possible,biallelic
DVL3	confirmed,monoallelic
EMC1	probable,biallelic
EMC1	probable,monoallelic
FGFR1	confirmed,mosaic
PIGG	probable,biallelic
GTF2E2	probable,biallelic
SMG9	probable,biallelic
PDE10A	probable,monoallelic
TBCK	confirmed,biallelic
GNAQ	probable,mosaic
GNA11	probable,mosaic
TELO2	probable,biallelic
RERE	confirmed,monoallelic
ITPR1	confirmed,monoallelic
ITPR1	confirmed,biallelic
TRMT10C	probable,biallelic
GNB1	confirmed,monoallelic
GNB3	possible,biallelic
PRDM6	possible,monoallelic
FLAD1	confirmed,biallelic
SAMD9L	possible,monoallelic
MAFB	probable,monoallelic
TKT	probable,biallelic
BGN	probable,hemizygous
FRRS1L	probable,biallelic
SMO	confirmed,mosaic
TFRC	possible,biallelic
FZD5	probable,monoallelic
COL6A1	confirmed,monoallelic
CDC45	confirmed,biallelic
SEC61A1	possible,monoallelic
VAC14	possible,biallelic
TMEM126B	confirmed,biallelic
TSEN15	probable,biallelic
KLHL7	probable,biallelic
POT1	possible,biallelic
CCDC88A	possible,
PPP1CB	confirmed,monoallelic
NONO	probable,hemizygous
ATAD3A	confirmed,monoallelic
GORAB	confirmed,biallelic
CYP24A1	possible,biallelic
UBA5	confirmed,biallelic
TBX15	confirmed,biallelic
CHD4	confirmed,monoallelic
SH3BP2	possible,monoallelic
CDK13	confirmed,monoallelic
PRKD1	confirmed,monoallelic
CREBBP	confirmed,
KPNA7	possible,
TLK2	possible,monoallelic
PPA2	confirmed,biallelic
NAA10	confirmed,
NAA10	confirmed,
SMCHD1	both DD and IF,monoallelic
MYT1	possible,monoallelic
PKD1L1	confirmed,biallelic
MAP3K7	probable,monoallelic
MAP3K7	probable,monoallelic
IL11RA	probable,biallelic
IL11RA	confirmed,biallelic
EIF2S3	probable,hemizygous
PPP1R15B	possible,biallelic
NCAPD2	possible,
NCAPD3	possible,
NCAPH	possible,biallelic
ARCN1	probable,monoallelic
PIGY	probable,biallelic
HTRA2	possible,biallelic
PIEZO1	probable,biallelic
SNORD118	both DD and IF,biallelic
OTULIN	confirmed,biallelic
USP18	probable,biallelic
BGN	both DD and IF,hemizygous
NLRP5	probable,
NANS	confirmed,biallelic
TRIT1	possible,biallelic
PIEZO2	confirmed,biallelic
BRPF1	confirmed,monoallelic
HIVEP2	confirmed,monoallelic
CRIM1	possible,biallelic
HMGB3	possible,hemizygous
KMT2B	probable,monoallelic
SETD1A	probable,monoallelic
STAG1	confirmed,monoallelic
SLC1A2	probable,monoallelic
ELMO2	probable,biallelic
IARS	probable,biallelic
GNA14	probable,mosaic
TTC25	probable,biallelic
DNAJB13	possible,biallelic
CIT	probable,biallelic
SIN3A	probable,monoallelic
GNB5	probable,biallelic
SON	confirmed,monoallelic
HNRNPH2	probable,x-linked dominant
SLC5A7	probable,biallelic
EMG1	probable,biallelic
GRIN2D	probable,monoallelic
ATAD3A	probable,biallelic
SLC25A4	probable,monoallelic
NAXE	probable,biallelic
FGF12	confirmed,monoallelic
EBF3	confirmed,monoallelic
KIDINS220	probable,monoallelic
MBOAT7	probable,biallelic
GLDN	probable,biallelic
TBCD	confirmed,biallelic
TBCE	probable,biallelic
ASXL2	probable,monoallelic
ARID2	probable,monoallelic
CARS2	probable,biallelic
CLTC	possible,monoallelic
CUL3	possible,
DLG4	probable,
FBXO11	possible,
HECW2	confirmed,monoallelic
MORC2	probable,
TRIP12	confirmed,monoallelic
PYROXD1	probable,biallelic
CRADD	probable,
SLC6A9	probable,biallelic
TMTC3	probable,biallelic
MECR	probable,biallelic
PROSC	probable,biallelic
CPAMD8	probable,biallelic
DENND5A	probable,biallelic
AP3B2	probable,biallelic
MITF	probable,biallelic
MDH2	probable,biallelic
PIH1D3	child IF,hemizygous
MYPN	child IF,biallelic
DNAJC12	probable,biallelic
KIAA2022	probable,x-linked dominant
MYH10	possible,monoallelic
LRP6	possible,monoallelic
PRUNE1	probable,biallelic
HIST1H4C	possible,monoallelic
EPB41L1	possible,monoallelic
HIST1H1E	probable,monoallelic
RAB11B	possible,monoallelic
PSMD12	possible,monoallelic
CDH1	both DD and IF,monoallelic
CTNND1	both DD and IF,monoallelic
ACTB	probable,
AFF3	probable,monoallelic
KIAA1109	probable,biallelic
BMP2	probable,
THOC6	confirmed,biallelic
DNAH5	probable,biallelic
FRMPD4	probable,hemizygous
KLHL15	possible,hemizygous
LAS1L	possible,
RLIM	probable,hemizygous
USP27X	probable,hemizygous
CDK16	possible,hemizygous
C21orf2	confirmed,biallelic
RRM2B	both DD and IF,biallelic
BHLHA9	confirmed,monoallelic
